[console_scripts]
metadata = metadata.cmd:metadata

[metadata.ingestion.bulksink.plugins]
elasticsearch = metadata.ingestion.bulksink.elastic_search:ElasticSearchBulkSink
metadata-usage = metadata.ingestion.bulksink.metadata_usage_rest:MetadataUsageBulkSink

[metadata.ingestion.processor.plugins]
pii-tags = metadata.ingestion.processor.pii_processor:PIIProcessor
query-parser = metadata.ingestion.processor.query_parser:QueryParserProcessor

[metadata.ingestion.sink.plugins]
console = metadata.ingestion.sink.console:ConsoleSink
file = metadata.ingestion.sink.file:FileSink
ldap-rest-users = metadata.ingestion.sink.ldap_add_user:LdapUserRestSink
metadata-rest-tables = metadata.ingestion.sink.metadata_tables_rest:MetadataTablesRestSink
metadata-rest-users = metadata.ingestion.sink.metadata_users_rest:MetadataUsersRestSink

[metadata.ingestion.source.plugins]
athena = metadata.ingestion.source.athena:AthenaSource
bigquery = metadata.ingestion.source.bigquery:BigQuerySource
hive = metadata.ingestion.source.hive:HiveSource
ldap-users = metadata.ingestion.source.ldap_source:LDAPUserSource
metadata-rest-tables = metadata.ingestion.source.metadata_rest:MetadataTablesRestSource
mssql = metadata.ingestion.source.mssql:SQLServerSource
mysql = metadata.ingestion.source.mysql:MySQLSource
oracle = metadata.ingestion.source.oracle:OracleSource
postgres = metadata.ingestion.source.postgres:PostgresSource
redshift = metadata.ingestion.source.redshift:RedshiftSource
redshift-sql = metadata.ingestion.source.redshift_sql:RedshiftSQLSource
redshift-usage = metadata.ingestion.source.redshift_usage:RedshiftUsageSource
sample-tables = metadata.ingestion.source.sample_data_generator:SampleTableSource
sample-users = metadata.ingestion.source.sample_data_generator:SampleUserSource
snowflake = metadata.ingestion.source.snowflake:SnowflakeSource
snowflake-usage = metadata.ingestion.source.snowflake_usage:SnowflakeUsageSource

[metadata.ingestion.stage.plugins]
file-stage = metadata.ingestion.stage.file:FileStage
table-usage-stage = metadata.ingestion.stage.table_usage_stage:TableUsageStage

